Left,Left,Left,Left,Down,Down,Down,Down,Right,Right,Right,Right
Ghoul,Strong,Wizard,Mounted,Ghoul,Strong,Wizard,Mounted,Ghoul,Strong,Wizard,Mounted
0,0,0,0,6,1,0,0,0,0,0,0
1,0,1,0,3,2,1,0,1,0,0,0
2,0,0,2,3,3,2,0,1,1,0,0
2,1,2,3,4,3,2,1,0,2,1,0
0,0,0,0,0,0,0,0,0,0,0,0
0,0,0,0,0,0,0,0,0,0,0,0
0,0,0,0,0,0,0,0,0,0,0,0
0,0,0,0,10,0,0,0,0,0,0,0
