Left,Left,Left,Left,Down,Down,Down,Down,Right,Right,Right,Right
Ghoul,Strong,Wizard,Mounted,Ghoul,Strong,Wizard,Mounted,Ghoul,Strong,Wizard,Mounted
0,0,2,0,8,0,3,0,3,0,0,0
3,1,6,4,0,3,6,6,3,3,3,1
6,3,6,4,6,3,8,6,4,3,5,1
7,8,10,8,12,6,12,3,6,6,7,3
12,10,14,13,14,8,14,10,16,7,10,4
16,10,15,16,18,12,16,10,16,7,11,6
20,10,20,16,22,12,24,10,16,9,14,6
