Left,Left,Left,Left,Down,Down,Down,Down,Right,Right,Right,Right
Ghoul,Strong,Wizard,Mounted,Ghoul,Strong,Wizard,Mounted,Ghoul,Strong,Wizard,Mounted
0,0,2,0,8,0,3,0,3,0,0,0
3,1,6,4,0,3,6,6,3,3,3,1
8,4,8,3,3,0,8,3,1,2,4,2
6,6,12,4,6,3,10,4,6,4,5,2
3,8,10,8,12,6,12,3,6,6,7,3
12,10,14,13,14,8,14,10,16,7,10,4
16,10,15,16,18,8,16,10,16,7,11,6
