Left,Left,Left,Left,Down,Down,Down,Down,Right,Right,Right,Right
Ghoul,Strong,Wizard,Mounted,Ghoul,Strong,Wizard,Mounted,Ghoul,Strong,Wizard,Mounted
0,0,2,0,8,0,3,0,3,0,0,0
4,0,3,1,6,2,4,0,1,0,0,0
3,1,4,3,0,3,5,2,3,3,2,1
8,4,8,2,3,0,3,0,1,0,0,0
6,1,6,4,6,3,6,4,6,1,3,1
3,4,8,2,6,4,8,3,6,1,4,2
6,4,9,3,8,2,8,4,2,2,6,3
